71 68
g g g g g g g g g g g g g g g g g g g g g g g g g g g g g g g g g g g g g g g t t g g g g g g g g g g g g g g g g g g g g g g g g g g g g g g
g g g g g g g g g g g g g g g g g g g g g g g g g g g g g g g g g g g g g g g t t g g g g g g g g g g g g g g g g g g g g g g g g g g g g g g
g g g g g g g g g g g g g g g g g g g g g g g g g g g g g g g g g g g g g g g t t g g g g g g g g g g g g g g g g g g g g g g g g g g g g g g
g g g g g g g g g g g g g g g g g g g g g g g g g g g g g g g g g g g g g g g t t g g g g g g g g g g g g g g g g g g g g g g g g g g g g g g
g g g g g g g g g g g g g g g g g g g g g g g g g g g g g g g g g g g g g g g t t g g g g g g g g g g g g g g g g g g g g g g g g g g g g g g
g g g g g g g g g g g g g g g g g g g g g g g g g g g g g g g g g g g g g g g t t g g g g g g g g g g g g g g g g g g g g g g g g g g g g g g
g g g g g g g g g g g g g g g g g g g g g g g g g g g g g g g g g g g g g g g t t g g g g g g g g g g g g g g g g g g g g g g g g g g g g g g
g g g g g g g g g g g g g g g g g g g g g g g g g g g g g g g g g g g g g g g t t g g g g g g g g g g g g g g g g g g g g g g g g g g g g g g
g g g g g g g g g g g g g g g g g g g g g g g g g g g g g g g g g g g g g g g t t g g g g g g g g g g g g g g g g g g g g g g g g g g g g g g
g g g g g g g g g g g g w w w w w w w w w w w w w w w w w w w w w w w w w w w t t w w w w w w w w w w w w w w w w w w w g g g g g g g g g g g
g g g g g g g g g g g g w w w w w w w w w w w w w w w w w w w w w w w w w w w t t w w w w w w w w w w w w w w w w w w w g g g g g g g g g g g
g g g g g g g g g g g g w w g g g g g g g g g g g g g g g g g g g g g g g g g t t g g g g g g g g g g g g g g g g g w w g g g g g g g g g g g
g g g g g g g g g g g g w w g H s s s s s s s g g H s s s s s s s g g g g g g t t g g g g g g g g g g g g g g g g g w w g g g g g g g g g g g
g g g g g g g g g g g g w w g s s s s s s s s g g s s s s s s s s g g g g g g t t g g g g g g g g g g g g g g g g g w w g g g g g g g g g g g
g g g g g g g g g g g g w w g s s s s s s s s g g s s s s s s s s g g g g g g t t g g g g g g H s s s s s s s g g g w w g g g g g g g g g g g
g g g g g g g g g g g g w w g s s s s s s s s g g s s s s s s s s g g g g g g t t g g g g g g s s s s s s s s g g g w w g g g g g g g g g g g
g g g g g g g g g g g g w w g s s s s s s s s g g s s s s s s s s g g g g g g t t g g g g g g s s s s s s s s g g g w w g g g g g g g g g g g
g g g g g g g g g g g g w w g s s s s D s s s g g s s s s D s s s g g g g g g t t g g g g g g s s s s s s s s g g g w w g g g g g g g g g g g
g g g g g g g g g g g g w w g g g g g t g g g g g g b g g t g g g g g g g g g t t g g g g g g s s s s s s s s g g g w w g g g g g g g g g g g
g g g g g g g g g g g g w w g g g g g t t t t t t t t t t t t t t t t t t t t t t g g g g g g s s s s D s s s g g g w w g g g g g g g g g g g
g g g g g g g g g g g g w w g g g g g g g g g g g g g g g g g g g g g g g g g t t g g g g g g g g g g t g g g g g g w w g g g g g g g g g g g
g g g g g g g g g g g g w w g g g g g g g g g g g g g g g g g g g g g g g g g t t g g g g g g g g g g t g g g g g g w w g g g g g g g g g g g
g g g g g g g g g g g g w w g g g g g g g g g g g H s s s s s s s g g g g g g t t t t t t t t t t t t t t g g g g g w w g g g g g g g g g g g
g g g g g g g g g g g g w w H s s s s s s s g g g s s s s s s s s g g g g g g t t g g g g g g g g g g g t g g g g g w w g g g g g g g g g g g
g g g g g g g g g g g g w w s s s s s s s s g g g s s s s s s s s g g g g g g t t g g g g g g g g g g g t g g g g g w w g g g g g g g g g g g
g g g g g g g g g g g g w w s s s s s s s s g g g s s s s s s s s g g g g g g t t g g g g b g g g g g g t g g b g g w w g g g g g g g g g g g
g g g g g g g g g g g g w w s s s s s s s s g g g s s s s s s s s g g g g g g t t g g g g g g g g g g b t t t t g g w w g g g g g g g g g g g
g g g g g g g g g g g g w w s s s s s s s s g g g s s s s D s s s g g g g g g t t g g g g g g g g g g g g g g t g g w w g g g g g g g g g g g
g g g g g g g g g g g g w w s s s s D s s s g g g g g g g t g g g g g g g g g t t g g g g g g g g g g g g g g t g g w w g g g g g g g g g g g
g g g g g g g g g g g g w w g g g g t g g g g g g g b g g t g g g g g g g g g t t g g g b g g g g g g g g g b t g g w w g g g g g g g g g g g
g g g g g g g g g g g g w w g g g g t g g g g g g g g g g t g g g g g g g g g t t g g g g g g g b g g g g g g t g g w w g g g g g g g g g g g
g g g g g g g g g g g g w w g g g g t g g b g g g g g g g t g g g g g g g g b t t b g g g g g g g g g g g g g t g g w w g g g g g g g g g g g
t t t t t t t t t t t t w d t t t t t t t t t t t t t t t t t t t t t t t t t t t t t t t t t t t t t t t t t t t t d w t t t t t t t t t t t
t t t t t t t t t t t t w d t t t t t t t t t t t t t t t t t t t t t t t t t t t t t t t t t t t t t t t t t t t t d w t t t t t t t t t t t
g g g g g g g g g g g g w w g g g g g g g g g g t g g g g g g g g g g g g g b t t b g g g g g g g g g g g g g g g g w w g g g g g g g g g g g
g g g g g g g g g g g g w w g g g g g g g g g g t g g g g g g g g g g g g g g t t g g g g g g g g g g g g g g b g g w w g g g g g g g g g g g
g g g g g g g g g g g g w w g g g g g g g g g g t g g g g g g g g g g g g g g t t g g g g g g g g g g g g b g g g g w w g g g g g g g g g g g
g g g g g g g g g g g g w w g g g g g g g g g g t g g g g g g g g g g g g g g t t g g g g g g g g g g g g g g b g g w w g g g g g g g g g g g
g g g g g g g g g g g g w w g g g g g g g g g g t g g g g g g g g g g g g g g t t g g g g g b g g g g g g g g g g g w w g g g g g g g g g g g
g g g g g g g g g g g g w w g g g g g g g g g g t g g g g g g g g g g g g g g t t g g g g g g g b g g g g g g g g g w w g g g g g g g g g g g
g g g g g g g g g g g g w w g g g g g g g g g g t g g g g g g g g g g g g g g t t g g g g g g g g g g g g g g g g g w w g g g g g g g g g g g
g g g g g g g g g g g g w w g H s s s s s s s g t g g g g g g g g g g g g g g t t g g g b g g g g g g g g b g g g g w w g g g g g g g g g g g
g g g g g g g g g g g g w w g s s s s s s s s g t g g g g g g g g g g g g g g t t g g g g g g g g b g g g g g g g g w w g g g g g g g g g g g
g g g g g g g g g g g g w w g s s s s s s s s g t g g g g g g g g g g g g g g t t g g g g g g g g g g g g g g g g g w w g g g g g g g g g g g
g g g g g g g g g g g g w w g s s s s s s s s g t g g g g g g g g g g g g g g t t g g g g g g g g g g g g g g g g g w w g g g g g g g g g g g
g g g g g g g g g g g g w w g s s s s s s s s g t g g g g g g g g g g g g g g t t g g g g g g g g g g g g g g g g g w w g g g g g g g g g g g
g g g g g g g g g g g g w w g s s s s D s s s g t g g H s s s s s s s g g g g t t g g g g g g g H s s s s s s s g g w w g g g g g g g g g g g
g g g g g g g g g g g g w w g g g g g t g g g g t g g s s s s s s s s g g g g t t g g g g g g g s s s s s s s s g g w w g g g g g g g g g g g
g g g g g g g g g g g g w w g g g g g t t t t t t g g s s s s s s s s g g g g t t g g g g g g g s s s s s s s s g g w w g g g g g g g g g g g
g g g g g g g g g g g g w w g g g g g g g g g g t g g s s s s s s s s g g g g t t g g g g g g g s s s s s s s s g g w w g g g g g g g g g g g
g g g g g g g g g g g g w w g g g g g g g g g g t g g s s s s s s s s g g g g t t g g g g g g g s s s s s s s s g g w w g g g g g g g g g g g
g g g g g g g g g g g g w w g g g g g g g g g g t g g s s s s D s s s g g g g t t g g g g g g g s s s s D s s s g g w w g g g g g g g g g g g
g g g g g g g g g g g g w w g g g g g g g g g g t g g g g g g t g g g g g g g t t g g g g g g g g g g g t g g g g g w w g g g g g g g g g g g
g g g g g g g g g g g g w w g g g g g g g g g g t g g g g g g t g g g g g g g t t g g g g g g g g g g t t g g g g g w w g g g g g g g g g g g
g g g g g g g g g g g g w w g g g g g g g g g g t t t t t t t t t t t t t t t t t t t t t t t t t t t t g g g g g g w w g g g g g g g g g g g
g g g g g g g g g g g g w w g g g g g g g g g g t g g g g g g g g g g g g g g t t g g g g g g g g g g g g g g g g g w w g g g g g g g g g g g
g g g g g g g g g g g g w w g g g g g g g g g g t g g g g g g g g g g g g g g t t g g g g g g g g g g g g g g g g g w w g g g g g g g g g g g
g g g g g g g g g g g g w w g g g g g g g g g g t g g g g g g g g g g g g r r r r r r g g g g g g g g g g g g g g g w w g g g g g g g g g g g
g g g g g g g g g g r r w w r g g r r r g g g g t b g g g g r r r r r r r r r r r r r r g g g g g g g g g g g g g g w w g g g g g g g g g g g
r r r r r r r r r r r r r r r r r r r r r r r r r r r r r r r r r r r r r r r r r r r r r r r r g g g g g g g g r r w w r r r r r r r r r r r
r r r r r r r r r r r r r r r r r r r r r r r r r r r r r r r r r r r r r r r r r r r r r r r r r r r r b g r r r r r r r r r r r r r r r r r
r r r r r r r r r r r r r r r r r r r r r r r r r r r r r r r r r r r r r r r r r r r r r r r r r r r r r r r r r r r r r r r r r r r r r r r
r r r r r r r r r r r r r r r r r r r r r r r r r r r r r r r r r r r r r r r r r r r r r r r r r r r r r r r r r r r r r r r r r r r r r r r
r r r r r r r r r r r r r r r r r r r r r r r r r r r r r r r r r r r r r r r r r r r r r r r r r r r r r r r r r r r r r r r r r r r r r r r
r r r r r r r r r r r r r r r r r r r r r r r r r r r r r r r r r r r r r r r r r r r r r r r r r r r r r r r r r r r r r r r r r r r r r r r
r r r r r r r r r r r r r r r r r r r r r r r r r r r r r r r r r r r r r r r r r r r r r r r r r r r r r r r r r r r r r r r r r r r r r r r
r r r r r r r r r r r r r r r r r r r r r r r r r r r r r r r r r r r r r r r r r r r r r r r r r r r r r r r r r r r r r r r r r r r r r r r
r r r r r r r r r r r r r r r r r r r r r r r r r r r r r r r r r r r r r r r r r r r r r r r r r r r r r r r r r r r r r r r r r r r r r r r
