71 68
g g g g g g g g g g g g g g g g g g g g g g g g g g g g g g g g g g g g g g g t t g g g g g g g g g g g g g g g g g g g g g g g g g g g g g g
g g g g g g g g g g g g g g g g g g g g g g g g g g g g g g g g g g g g g g g t t g g g g g g g g g g g g g g g g g g g g g g g g g g g g g g
g g g g g g g g g g g g g g g g g g g g g g g g g g g g g g g g g g g g g g g t t g g g g g g g g g g g g g g g g g g g g g g g g g g g g g g
g g g g g g g g g g g g g g g g g g g g g g g g g g g g g g g g g g g g g g g t t g g g g g g g g g g g g g g g g g g g g g g g g g g g g g g
g g g g g g g g g g g g g g g g g g g g g g g g g g g g g g g g g g g g g g g t t g g g g g g g g g g g g g g g g g g g g g g g g g g g g g g
g g g g g g g g g g g g g g g g g g g g g g g g g g g g g g g g g g g g g g g t t g g g g g g g g g g g g g g g g g g g g g g g g g g g g g g
g g g g g g g g g g g g g g g g g g g g g g g g g g g g g g g g g g g g g g g t t g g g g g g g g g g g g g g g g g g g g g g g g g g g g g g
g g g g g g g g g g g g g g g g g g g g g g g g g g g g g g g g g g g g g g g t t g g g g g g g g g g g g g g g g g g g g g g g g g g g g g g
g g g g g g g g g g g g x x x x x x x x x x x x x x x x x x x x x x x x x x x t t x x x x x x x x x x x x x x x x x x x g g g g g g g g g g g
g g g g g g g g g g g g # x x x x x x x x x x x x x x x x x x x x x x x x x # t t # x x x x x x x x x x x x x x x x x # g g g g g g g g g g g
g g g g g g g g g g g g | _ _ _ _ _ _ _ _ _ _ _ _ _ _ _ _ _ _ _ _ _ _ _ _ _ x t t x _ _ _ _ _ _ _ _ _ _ _ _ _ _ _ _ _ | g g g g g g g g g g g
g g g g g g g g g g g g | g g g g g g g g g g g g g g g g g g g g g g g g g g t t g g g g g g g g g g g g g g g g g g | g g g g g g g g g g g
g g g g g g g g g g g g | g g H s s s s s s s g g H s s s s s s s g g g g g g t t g g g g g g g g g g g g g g g g g g | g g g g g g g g g g g
g g g g g g g g g g g g | g g s s s s s s s s g g s s s s s s s s g g g g g g t t g g g g g g g g g g g g g g g g g g | g g g g g g g g g g g
g g g g g g g g g g g g | g g s s s s s s s s g g s s s s s s s s g g g g g g t t g g g g g g H s s s s s s s g g g g | g g g g g g g g g g g
g g g g g g g g g g g g | g g s s s s s s s s g g s s s s s s s s g g g g g g t t g g g g g g s s s s s s s s g g g g | g g g g g g g g g g g
g g g g g g g g g g g g | g g s s s s s s s s g g s s s s s s s s g g g g g g t t g g g g g g s s s s s s s s g g g g | g g g g g g g g g g g
g g g g g g g g g g g g | g g s s s s D s s s g g s s s s D s s s g g g g g g t t g g g g g g s s s s s s s s g g g g | g g g g g g g g g g g
g g g g g g g g g g g g | g g g g g g t g g g g g g b g g t g g g g g g g g g t t g g g g g g s s s s s s s s g g g g | g g g g g g g g g g g
g g g g g g g g g g g g | g g g g g g t t t t t t t t t t t t t t t t t t t t t t g g g g g g s s s s D s s s g g g g | g g g g g g g g g g g
g g g g g g g g g g g g | g g g g g g g g g g g g g g g g g g g g g g g g g g t t g g g g g g g g g g t g g g g g g g | g g g g g g g g g g g
g g g g g g g g g g g g | g g g g g g g g g g g g g g g g g g g g g g g g g g t t g g g g g g g g g g t g g g g g g g | g g g g g g g g g g g
g g g g g g g g g g g g | g g g g g g g g g g g g H s s s s s s s g g g g g g t t t t t t t t t t t t t t g g g g g g | g g g g g g g g g g g
g g g g g g g g g g g g | g H s s s s s s s g g g s s s s s s s s g g g g g g t t g g g g g g g g g g g t g g g g g g | g g g g g g g g g g g
g g g g g g g g g g g g | g s s s s s s s s g g g s s s s s s s s g g g g g g t t g g g g g g g g g g g t g g g g g g |  g g g g g g g g g g g
g g g g g g g g g g g g | g s s s s s s s s g g g s s s s s s s s g g g g g g t t g g g g b g g g g g g t g g b g g g | g g g g g g g g g g g
g g g g g g g g g g g g | g s s s s s s s s g g g s s s s s s s s g g g g g g t t g g g g g g g g g g b t t t t g g g | g g g g g g g g g g g
g g g g g g g g g g g g | g s s s s s s s s g g g s s s s D s s s g g g g g g t t g g g g g g g g g g g g g g t g g g | g g g g g g g g g g g
g g g g g g g g g g g g | g s s s s D s s s g g g g g g g t g g g g g g g g g t t g g g g g g g g g g g g g g t g g g | g g g g g g g g g g g
g g g g g g g g g g g g | g g g g g t g g g g g g g b g g t g g g g g g g g g t t g g g b g g g g g g g g g b t g g g | g g g g g g g g g g g
g g g g g g g g g g g g | g g g g g t g g g g g g g g g g t g g g g g g g g g t t g g g g g g g b g g g g g g t g g g | g g g g g g g g g g g
g g g g g g g g g g g g | g g g g g t g g b g g g g g g g t g g g g g g g g b t t b g g g g g g g g g g g g g t g g g | g g g g g g g g g g g
t t t t t t t t t t t t | g t t t t t t t t t t t t t t t t t t t t t t t t t t t t t t t t t t t t t t t t t t t t g | t t t t t t t t t t t
t t t t t t t t t t t t | g t t t t t t t t t t t t t t t t t t t t t t t t t t t t t t t t t t t t t t t t t t t t g | t t t t t t t t t t t
g g g g g g g g g g g g | g g g g g g g g g g g t g g g g g g g g g g g g g b t t b g g g g g g g g g g g g g g g g g | g g g g g g g g g g g
g g g g g g g g g g g g | g g g g g g g g g g g t g g g g g g g g g g g g g g t t g g g g g g g g g g g g g g b g g g | g g g g g g g g g g g
g g g g g g g g g g g g | g g g g g g g g g g g t g g g g g g g g g g g g g g t t g g g g g g g g g g g g b g g g g g | g g g g g g g g g g g
g g g g g g g g g g g g | g g g g g g g g g g g t g g g g g g g g g g g g g g t t g g g g g g g g g g g g g g b g g g | g g g g g g g g g g g
g g g g g g g g g g g g | g g g g g g g g g g g t g g g g g g g g g g g g g g t t g g g g g b g g g g g g g g g g g g | g g g g g g g g g g g
g g g g g g g g g g g g | g g g g g g g g g g g t g g g g g g g g g g g g g g t t g g g g g g g b g g g g g g g g g g | g g g g g g g g g g g
g g g g g g g g g g g g | g g g g g g g g g g g t g g g g g g g g g g g g g g t t g g g g g g g g g g g g g g g g g g | g g g g g g g g g g g
g g g g g g g g g g g g | g g H s s s s s s s g t g g g g g g g g g g g g g g t t g g g b g g g g g g g g b g g g g g | g g g g g g g g g g g
g g g g g g g g g g g g | g g s s s s s s s s g t g g g g g g g g g g g g g g t t g g g g g g g g b g g g g g g g g g | g g g g g g g g g g g
g g g g g g g g g g g g | g g s s s s s s s s g t g g g g g g g g g g g g g g t t g g g g g g g g g g g g g g g g g g | g g g g g g g g g g g
g g g g g g g g g g g g | g g s s s s s s s s g t g g g g g g g g g g g g g g t t g g g g g g g g g g g g g g g g g g | g g g g g g g g g g g
g g g g g g g g g g g g | g g s s s s s s s s g t g g g g g g g g g g g g g g t t g g g g g g g g g g g g g g g g g g | g g g g g g g g g g g
g g g g g g g g g g g g | g g s s s s D s s s g t g g H s s s s s s s g g g g t t g g g g g g g H s s s s s s s g g g | g g g g g g g g g g g
g g g g g g g g g g g g | g g g g g g t g g g g t g g s s s s s s s s g g g g t t g g g g g g g s s s s s s s s g g g | g g g g g g g g g g g
g g g g g g g g g g g g | g g g g g g t t t t t t g g s s s s s s s s g g g g t t g g g g g g g s s s s s s s s g g g |  g g g g g g g g g g g
g g g g g g g g g g g g | g g g g g g g g g g g t g g s s s s s s s s g g g g t t g g g g g g g s s s s s s s s g g g | g g g g g g g g g g g
g g g g g g g g g g g g | g g g g g g g g g g g t g g s s s s s s s s g g g g t t g g g g g g g s s s s s s s s g g g | g g g g g g g g g g g
g g g g g g g g g g g g | g g g g g g g g g g g t g g s s s s D s s s g g g g t t g g g g g g g s s s s D s s s g g g | g g g g g g g g g g g
g g g g g g g g g g g g | g g g g g g g g g g g t g g g g g g t g g g g g g g t t g g g g g g g g g g g t g g g g g g | g g g g g g g g g g g
g g g g g g g g g g g g | g g g g g g g g g g g t g g g g g g t g g g g g g g t t g g g g g g g g g g t t g g g g g g | g g g g g g g g g g g
g g g g g g g g g g g g | g g g g g g g g g g g t t t t t t t t t t t t t t t t t t t t t t t t t t t t g g g g g g g | g g g g g g g g g g g
g g g g g g g g g g g g | g g g g g g g g g g g t g g g g g g g g g g g g g g t t g g g g g g g g g g g g g g g g g g | g g g g g g g g g g g
g g g g g g g g g g g g | g g g g g g g g g g g t g g g g g g g g g g g g g g t t g g g g g g g g g g g g g g g g g g | g g g g g g g g g g g
g g g g g g g g g g g g | g g g g g g g g g g g t g g g g g g g g g g g g r r r r r r g g g g g g g g g g g g g g g g | g g g g g g g g g g g
g g g g g g g g g g r r | g r g g r r r g g g g t b g g g g r r r r r r r r r r r r r r g g g g g g g g g g g g g g g | g g g g g g g g g g g
r r r r r r r r r r r r r r r r r r r r r r r r t r r r r r r r r r r r r r r r r r r r r r r r g g g g g g g g r r g | r r r r r r r r r r r
r r r r r r r r r r r r r r r r r r r r r r r r t r r r r r r r r r r r r r r r r r r r r r r r r r r r b g r r r r r r r r r r r r r r r r r
r r r r r r r r r r r r r r r r r r r r r r r r t r r r r r r r r r r r r r r r r r r r r r r r r r r r r r r r r r r r r r r r r r r r r r r
r r r r r r r r r r r r r r r r r r r r r r r r r r r r r r r r r r r r r r r r r r r r r r r r r r r r r r r r r r r r r r r r r r r r r r r
r r r r r r r r r r r r r r r r r r r r r r r r r r r r r r r r r r r r r r r r r r r r r r r r r r r r r r r r r r r r r r r r r r r r r r r
r r r r r r r r r r r r r r r r r r r r r r r r r r r r r r r r r r r r r r r r r r r r r r r r r r r r r r r r r r r r r r r r r r r r r r r
r r r r r r r r r r r r r r r r r r r r r r r r r r r r r r r r r r r r r r r r r r r r r r r r r r r r r r r r r r r r r r r r r r r r r r r
r r r r r r r r r r r r r r r r r r r r r r r r r r r r r r r r r r r r r r r r r r r r r r r r r r r r r r r r r r r r r r r r r r r r r r r
r r r r r r r r r r r r r r r r r r r r r r r r r r r r r r r r r r r r r r r r r r r r r r r r r r r r r r r r r r r r r r r r r r r r r r r
